#######
#     #
# # $ #
#.  @ #
#.  $ #
#######
